1111111111111111111111111111
1000000010000011111100000001
1001001111111111100000000001
1000000000000011000000000011
1000000P00111111110000000111
1111100000000000000001111111
1000000111000000000111110001
1111101110111110111110111111
1000000000000000000000000001
1000000010000011111100000001
1000000010000011111100000001
1000000010000011111100000001
1000000000000000001111111111
1111111000000C00000000000001
11111111110000C000000000E001
1000000000000C00001111111111
1000000100000000111000000001
1111111111111111111111111111