11111111111111111111
1EC0000C000C00P00001
11111111111111111111