111111111111111
1111111P1111111
1111111E1111111
111111111111111
111111111111111