1111111111111111111111111111
1000C000100000111111000C0001
1001001111111111100000000001
1000C000C0000011000C00000011
1000000P00111111110000000111
111110000000C00C000001111111
1000000111000000000111110001
1111101110111110111110111111
10000000000C0000000000000001
100000001000C011111100000001
1000000010000011111100000001
1000000010000011111100000001
10000000000C0000001111111111
1111111000000C00000000000001
11111111110000C000000000E001
1000000000000C00001111111111
1000000100000000111000000001
1111111111111111111111111111