111111111111111
100000011111001
111100011111001
1E0000000000001
111000000000001
100011111100001
100P00C00C000C1
111111111111111