111111111111111
100000011110001
100000011111001
10E000000000001
100000000000001
100011111100001
100000C00C000C1
111111111111111