11111111111111111111111111111111111111111111111111111111111111111111111111111111111111111111111111111111111111111111111111111111111111111111111
10000000100000111111000000011111111111111111111111111111111111111111111111111111111111111111111111111111111111111111111111111111111111111111111
10010011111111111000000000011111111111111111111111111111111111111111111111111111111111111111111111111111111111111111111111111111111111111111111
10000000000000110000000000111111111111111111111111111111111111111111111111111111111111111111111111111111111111111111111111111111111111111111111
1000000P001111111100000001111111111111111111111111111111111111111111111111111111111111111111111111111111111111111111111111111111111111111111111
11111000000000000000011111111111111111111111111111111111111111111111111111111111111111111111111111111111111111111111111111111111111111111111111
10000001110000000001111100011111111111111111111111111111111111111111111111111111111111111111111111111111111111111111111111111111111111111111111
11111011101111101111101111111111111111111111111111111111111111111111111111111111111111111111111111111111111111111111111111111111111111111111111
10000000000000000000000000011111111111111111111111111111111111111111111111111111111111111111111111111111111111111111111111111111111111111111111
10000000100000111111000000011111111111111111111111111111111111111111111111111111111111111111111111111111111111111111111111111111111111111111111
10000000100000111111000000011111111111111111111111111111111111111111111111111111111111111111111111111111111111111111111111111111111111111111111
10000000100000111111000000011111111111111111111111111111111111111111111111111111111111111111111111111111111111111111111111111111111111111111111
10000000000000000011111111111111111111111111111111111111111111111111111111111111111111111111111111111111111111111111111111111111111111111111111
1111111000000C000000000000011111111111111111111111111111111111111111111111111111111111111111111111111111111111111111111111111111111111111111111
11111111110000C000000000E0011111111111111111111111111111111111111111111111111111111111111111111111111111111111111111111111111111111111111111111
1000000000000C000011111111111111111111111111111111111111111111111111111111111111111111111111111111111111111111111111111111111111111111111111111
10000001000000001110000000011111111111111111111111111111111111111111111111111111111111111111111111111111111111111111111111111111111111111111111
11111111111111111111111111111111111111111111111111111111111111111111111111111111111111111111111111111111111111111111111111111111111111111111111