11111111111111111111111111111
1OOOOOOOOOOOOCOOOOOEOOOOOOOO1
1OOOOOOOOOOOOPOOOOOOOOOOOOO
11111111111111111111111111111